16 16
1111111111111111
10m0000000000001
1000000000000001
1000000000000001
1111111000001001
1000001000001001
1000001000001001
1000001000001001
1000001000001001
1000111111111001
1000000000000001
1111111111111001
1000000000000001
1011111111111111
1000000000000c01
1111111111111111